Country,Total cases,New cases,Total deaths,New deaths,Total recovered,Active cases,Critical cases,Cases per 1M pop.,Deaths per 1M pop.,Total tests done,Tests per 1M pop.,Gross Total cases,Gross Total deaths
USA,277522,361,7403,11,12283,257836,5787,838,22,1356085,4097,277883,7414
Italy,119827,0,14681,0,19758,85388,4068,1982,243,619849,10252,119827,14681
Spain,119199,0,11198,0,30513,77488,6416,2549,240,355000,7593,119199,11198
Germany,91159,0,1275,0,24575,65309,3936,1088,15,918460,10962,91159,1275
France,82165,0,6507,0,14008,61650,6662,1259,100,224254,3436,82165,6507
Iran,53183,0,3294,0,17935,31954,4035,633,39,80000,952,53183,3294
UK,38168,0,3605,0,135,34428,163,562,53,173784,2560,38168,3605
Turkey,20921,0,425,0,484,20012,1251,248,5,141716,1680,20921,425
Switzerland,19702,96,604,13,4846,14252,348,2276,70,145780,16844,19798,617
Belgium,16770,0,1143,0,2872,12755,1205,1447,99,62867,5424,16770,1143
Netherlands,15723,0,1487,0,250,13986,1324,918,87,75415,4401,15723,1487
Canada,12549,174,208,0,2322,10019,120,332,6,302745,8021,12723,208
Austria,11589,65,168,0,2022,9399,245,1287,19,98343,10919,11654,168
S. Korea,10156,94,177,3,6325,3654,55,198,3,455032,8875,10250,180
Portugal,9886,0,246,0,68,9572,245,970,24,52086,5108,9886,246
Brazil,9216,22,365,2,127,8724,296,43,2,54824,258,9238,367
Israel,7589,161,42,2,427,7120,115,877,5,90394,10443,7750,44
Sweden,6131,0,358,0,205,5568,469,607,35,36900,3654,6131,358
Australia,5550,96,30,2,585,4935,85,218,1,285675,11203,5646,32
Norway,5370,0,59,0,32,5279,96,991,11,101986,18812,5370,59
Russia,4731,582,43,9,333,4355,8,32,0,639000,4379,5313,52
Ireland,4273,0,120,0,25,4128,148,865,24,30213,6119,4273,120
Czechia,4194,4,56,3,74,4064,87,392,5,74170,6926,4198,59
Denmark,3757,0,139,0,1193,2425,153,649,24,40863,7055,3757,139
Chile,3737,0,22,0,427,3288,31,195,1,35142,1838,3737,22
Poland,3503,120,73,2,116,3314,50,93,2,66938,1769,3623,75
Ecuador,3368,0,145,0,65,3158,100,191,8,10317,585,3368,145
Malaysia,3333,0,53,0,827,2453,108,103,2,47723,1474,3333,53
Romania,3183,0,133,0,283,2767,83,165,7,31657,1646,3183,133
Philippines,3094,76,144,8,57,2893,1,28,1,5265,48,3170,152
India,3082,23,86,0,229,2767,0,2,0,116608,84,3105,86
Japan,2935,0,69,0,514,2352,60,23,0,39446,312,2935,69
Pakistan,2708,22,40,0,130,2538,13,12,0,30308,137,2730,40
Luxembourg,2612,0,31,0,500,2081,33,4173,50,21463,34287,2612,31
Thailand,2067,89,20,1,612,1435,23,30,0,23669,339,2156,21
Saudi Arabia,2039,0,25,0,351,1663,41,59,0,0,0,2039,25
Indonesia,1986,0,181,0,134,1671,0,7,0,7193,26,1986,181
Finland,1882,267,20,0,300,1562,72,340,4,26500,4783,2149,20
Mexico,1688,178,60,10,633,995,1,13,0,15668,122,1866,70
Panama,1673,0,41,0,10,1622,50,388,10,7333,1700,1673,41
Greece,1613,0,63,0,78,1472,92,155,6,22437,2153,1613,63
Peru,1595,0,61,0,537,997,51,48,2,16518,501,1595,61
South Africa,1505,0,9,0,95,1401,7,25,0,50361,849,1505,9
Dominican Republic,1488,0,68,0,16,1404,147,137,6,4200,387,1488,68
Serbia,1476,0,39,0,54,1383,81,169,4,5756,659,1476,39
Iceland,1364,0,4,0,336,1024,12,3997,12,22195,65042,1364,4
Argentina,1353,0,42,0,266,1045,0,30,0,7385,163,1353,42
Colombia,1267,0,25,0,55,1187,50,25,0,21202,417,1267,25
UAE,1264,0,9,0,108,1147,2,128,0,220000,22244,1264,9
Algeria,1171,0,105,0,62,1004,0,27,2,3359,77,1171,105
Singapore,1114,0,6,1,282,826,24,190,1,39000,6666,1114,7
Ukraine,1096,24,28,1,23,1045,16,25,0,5040,115,1120,29
Croatia,1079,0,8,0,92,979,39,263,2,8352,2034,1079,8
Qatar,1075,0,3,0,93,979,37,373,1,28413,9862,1075,3
Egypt,985,0,66,0,216,703,0,10,0,25000,244,985,66
Estonia,961,0,12,0,48,901,16,724,9,18290,13788,961,12
New Zealand,950,82,1,0,127,822,1,197,0,33116,6867,1032,1
Slovenia,934,0,20,0,70,844,31,449,10,25921,12468,934,20
Hong Kong,845,0,4,0,173,668,8,113,0,90000,12005,845,4
Morocco,844,53,50,2,59,735,1,23,1,4026,109,897,52
Iraq,820,0,54,0,226,540,0,20,1,0,0,820,54
Lithuania,771,75,9,0,7,755,11,283,3,21376,7852,846,9
Armenia,770,34,7,0,43,720,30,260,2,3994,1348,804,7
Hungary,678,55,32,6,58,588,17,70,3,19424,2011,733,38
Bahrain,673,1,4,0,388,281,3,396,2,38117,22401,674,4
Bosnia and Herzegovina,613,34,18,1,27,568,4,187,5,4696,1431,647,19
Moldova,591,0,8,0,26,557,65,147,2,169,42,591,8
Cameroon,509,0,8,0,17,484,0,19,0,0,0,509,8
Latvia,509,16,1,0,1,507,3,270,0,19380,10275,525,1
Lebanon,508,0,17,0,50,441,26,74,2,8472,1241,508,17
Kazakhstan,500,36,4,1,35,461,6,27,0,316,17,536,5
Bulgaria,498,13,14,0,34,450,21,72,2,566,81,511,14
Tunisia,495,0,18,0,5,472,26,42,2,5736,485,495,18
Slovakia,450,0,1,0,10,439,3,82,0,11742,2151,450,1
Azerbaijan,443,0,5,0,32,406,7,44,0,35000,3452,443,5
Andorra,439,0,16,0,16,407,12,5682,207,0,0,439,16
North Macedonia,430,0,12,0,20,398,8,206,6,4506,2163,430,12
Kuwait,417,0,1,1,82,334,16,98,0,0,0,417,2
Costa Rica,416,0,2,0,11,403,13,82,0,3845,755,416,2
Cyprus,396,0,11,0,28,357,11,328,9,9447,7825,396,11
Uruguay,386,0,4,0,86,296,13,111,1,4786,1378,386,4
Taiwan,355,7,5,0,50,300,0,15,0,35442,1488,362,5
Belarus,351,0,4,0,53,294,11,37,0,32000,3386,351,4
Réunion,321,0,0,0,40,281,3,359,0,0,0,321,0
Jordan,310,0,5,0,58,247,5,30,0,239,23,310,5
Albania,304,0,17,0,89,198,7,106,6,2031,706,304,17
Burkina Faso,302,0,16,0,50,236,0,14,0,0,0,302,16
Afghanistan,299,18,6,0,10,283,0,8,0,0,0,317,6
Oman,277,25,1,0,61,215,3,54,0,0,0,302,1
Cuba,269,0,6,0,15,248,8,24,0,3342,295,269,6
Honduras,264,42,15,0,3,246,10,27,2,0,0,306,15
San Marino,251,0,32,0,26,193,13,7397,943,586,17270,251,32
Uzbekistan,241,14,2,0,25,214,8,7,0,0,0,255,2
Vietnam,239,0,0,0,90,149,3,2,0,75458,775,239,0
Channel Islands,232,0,4,0,13,215,0,1334,23,0,0,232,4
Ivory Coast,218,0,1,0,19,198,0,8,0,0,0,218,1
Nigeria,210,0,4,0,25,181,0,1,0,0,0,210,4
Senegal,207,0,1,0,66,140,1,12,0,195,12,207,1
Ghana,205,0,5,0,31,169,2,7,0,0,0,205,5
Malta,202,0,0,0,2,200,2,457,0,9043,20480,202,0
Montenegro,197,23,2,0,1,194,4,314,3,1193,1899,220,2
Palestine,194,0,1,0,21,172,0,38,0,7553,1481,194,1
Mauritius,186,0,7,0,0,179,1,146,6,0,0,186,7
Faeroe Islands,181,2,0,0,93,88,2,3704,0,4800,98234,183,0
Sri Lanka,159,0,5,1,25,129,5,7,0,0,0,159,6
Georgia,156,1,0,0,28,128,6,39,0,0,0,157,0
Venezuela,153,0,7,0,52,94,6,5,0,1779,63,153,7
DRC,148,0,16,0,3,129,0,2,0,0,0,148,16
Kyrgyzstan,144,14,1,0,9,134,5,22,0,9618,1474,158,1
Martinique,143,0,3,0,27,113,18,381,8,0,0,143,3
Bolivia,139,7,10,1,1,128,3,12,0,591,51,146,11
Brunei,134,0,1,0,65,68,3,306,2,7566,17295,134,1
Guadeloupe,130,0,7,0,24,99,14,325,17,0,0,130,7
Mayotte,128,0,2,0,10,116,3,469,7,479,1756,128,2
Kenya,122,0,4,0,4,114,2,2,0,2201,41,122,4
Niger,120,0,5,0,0,115,0,5,0,3729,154,120,5
Isle of Man,114,0,1,0,0,113,0,1341,12,1230,14465,114,1
Cambodia,114,0,0,0,50,64,1,7,0,5768,345,114,0
Trinidad and Tobago,100,2,6,0,1,93,0,71,4,722,516,102,6
Paraguay,96,4,3,0,12,81,2,13,0,116,16,100,3
Gibraltar,95,0,0,0,46,49,0,2820,0,1136,33718,95,0
Rwanda,89,0,0,0,0,89,0,7,0,0,0,89,0
Liechtenstein,75,0,0,0,0,75,0,1967,0,900,23605,75,0
Guinea,73,0,0,0,2,71,0,6,0,0,0,73,0
Bangladesh,70,9,8,2,30,32,1,0,0,2086,13,79,10
Madagascar,70,0,0,0,0,70,6,3,0,0,0,70,0
Monaco,64,0,1,0,3,60,2,1631,25,0,0,64,1
Aruba,62,0,0,0,1,61,0,581,0,836,7830,62,0
French Guiana,57,0,0,0,22,35,1,191,0,0,0,57,0
El Salvador,56,10,3,0,0,53,4,9,0,0,0,66,3
Jamaica,53,0,3,0,7,43,0,18,1,442,149,53,3
Barbados,51,0,0,0,0,51,0,177,0,382,1329,51,0
Guatemala,50,0,1,0,12,37,1,3,0,0,0,50,1
Djibouti,49,0,0,0,8,41,0,50,0,0,0,49,0
Uganda,48,0,0,0,0,48,0,1,0,0,0,48,0
Macao,42,0,0,0,10,32,0,65,0,0,0,42,0
Togo,40,0,3,0,17,20,0,5,0,0,0,40,3
Mali,39,0,3,0,0,36,0,2,0,0,0,39,3
Zambia,39,0,1,0,2,36,0,2,0,619,34,39,1
French Polynesia,39,0,0,0,0,39,1,139,0,554,1972,39,0
Bermuda,35,0,0,0,14,21,0,562,0,272,4368,35,0
Ethiopia,35,0,0,0,3,32,2,0,0,1222,11,35,0
Cayman Islands,29,0,1,0,1,27,0,441,15,265,4032,29,1
Bahamas,24,0,3,0,0,21,1,61,8,0,0,24,3
Guyana,23,0,4,0,0,19,0,29,5,83,106,23,4
Sint Maarten,23,0,4,0,6,13,0,536,93,82,1912,23,4
Congo,22,0,2,0,2,18,0,4,0,0,0,22,2
Saint Martin,22,0,1,0,2,19,0,569,26,18,466,22,1
Eritrea,22,0,0,0,0,22,0,6,0,0,0,22,0
Gabon,21,0,1,0,1,19,0,9,0,0,0,21,1
Myanmar,20,0,1,0,0,19,0,0,0,0,0,20,1
Tanzania,20,0,1,0,3,16,0,0,0,0,0,20,1
Maldives,19,0,0,0,13,6,0,35,0,0,0,19,0
Haiti,18,0,0,0,1,17,0,2,0,200,18,18,0
New Caledonia,18,0,0,0,1,17,0,63,0,1390,4869,18,0
Libya,17,0,1,0,0,16,0,2,0,131,19,17,1
Syria,16,0,2,0,0,14,0,0,0,0,0,16,2
Benin,16,0,0,0,2,14,0,1,0,0,0,16,0
Equatorial Guinea,16,0,0,0,1,15,0,11,0,0,0,16,0
Antigua and Barbuda,15,0,0,0,0,15,1,153,0,9,92,15,0
Guinea-Bissau,15,0,0,0,0,15,0,8,0,0,0,15,0
Dominica,14,0,0,0,0,14,0,194,0,0,0,14,0
Mongolia,14,0,0,0,2,12,0,4,0,0,0,14,0
Namibia,14,0,0,0,3,11,0,6,0,301,118,14,0
Saint Lucia,13,0,0,0,1,12,0,71,0,0,0,13,0
Fiji,12,5,0,0,0,12,0,13,0,0,0,17,0
Grenada,12,0,0,0,0,12,2,107,0,45,400,12,0
Curaçao,11,0,1,0,3,7,0,67,6,0,0,11,1
Sudan,10,0,2,0,2,6,0,0,0,0,0,10,2
Suriname,10,0,1,0,0,9,0,17,2,0,0,10,1
Greenland,10,0,0,0,3,7,0,176,0,542,9547,10,0
Laos,10,0,0,0,0,10,0,1,0,437,60,10,0
Mozambique,10,0,0,0,0,10,0,0,0,0,0,10,0
Seychelles,10,0,0,0,0,10,0,102,0,0,0,10,0
MS Zaandam,9,0,2,0,0,7,0,0,0,0,0,9,2
Zimbabwe,9,0,1,0,0,8,0,0,0,316,21,9,1
Nepal,9,3,0,0,1,8,0,0,0,1185,41,12,0
Chad,9,1,0,0,0,9,0,0,0,0,0,10,0
Saint Kitts and Nevis,9,0,0,0,0,9,0,169,0,113,2124,9,0
Eswatini,9,0,0,0,0,9,0,8,0,0,0,9,0
Angola,8,0,2,0,1,5,0,0,0,0,0,8,2
CAR,8,0,0,0,0,8,0,2,0,0,0,8,0
Vatican City,7,0,0,0,0,7,0,8739,0,0,0,7,0
Liberia,7,0,0,0,0,7,0,1,0,0,0,7,0
St. Vincent Grenadines,7,0,0,0,1,6,0,63,0,0,0,7,0
Somalia,7,0,0,0,1,6,0,0,0,0,0,7,0
Cabo Verde,6,0,1,0,0,5,0,11,2,0,0,6,1
Mauritania,6,0,1,0,2,3,0,1,0,0,0,6,1
Montserrat,6,0,0,0,0,6,0,1202,0,0,0,6,0
St. Barth,6,0,0,0,1,5,0,607,0,0,0,6,0
Nicaragua,5,0,1,0,0,4,0,0,0,0,0,5,1
Bhutan,5,0,0,0,2,3,0,6,0,0,0,5,0
Turks and Caicos,5,0,0,0,0,5,0,129,0,0,0,5,0
Botswana,4,0,1,0,0,3,0,2,0,175,74,4,1
Gambia,4,0,1,0,2,1,0,2,0,0,0,4,1
Belize,4,0,0,0,0,4,0,10,0,25,63,4,0
Anguilla,3,0,0,0,0,3,0,200,0,0,0,3,0
British Virgin Islands,3,0,0,0,0,3,0,99,0,0,0,3,0
Burundi,3,0,0,0,0,3,0,0,0,2,0,3,0
Malawi,3,0,0,0,0,3,0,0,0,0,0,3,0
Caribbean Netherlands,2,0,0,0,0,2,0,76,0,10,381,2,0
Sierra Leone,2,0,0,0,0,2,0,0,0,2,0,2,0
Falkland Islands,1,0,0,0,0,1,0,287,0,0,0,1,0
Papua New Guinea,1,0,0,0,0,1,0,0,0,0,0,1,0
Timor-Leste,1,0,0,0,0,1,0,0,0,0,0,1,0
China,81639,19,3326,4,76755,1558,331,57,2,0,0,81658,3330
